02 00   11 00   10 00   07 -90  10  -90  05 -90  05 -90  08  90   10 00   15 00   12 00   16  00   04  00   01  00   02 00   00 00
00 00   11 00   08 180  08 90   08  -90  10 90   05 90   10  90   07 90   25 00   26 00   23  00   07 -90   07  00   00 00   03 00
03 00   07 180  08 00   08 -90  07  90   00 00   00 00   00  00   04 00   17 00   12 00   18  00   11  00   05  00   00 00   00 00
19 00   14 00   11 00   10 00   14 -90   21 00   19 00   21  00   19 00   13 90   12 00   18  00   11  00   05  00   00 00   00 00
12 00   16 00   11 00   10 00   15  00   12 00   12 00   12  00   12 00   12 00   12 00   18  00   06  00   05  00   00 00   00 00
13 -90  14 90   07 180  07 90   14 180   13 00   12 00   13 -90   22 00   13 00   12 00   18  00   11  00   08 180   06 90   06 90
18 00   00 00   04 00   03 00   00  00   14 180  13 00   16  00   02 00   17 00   12 00   18  00   07 180   11 -90   05 90   05 90
16 00   00 00   00 00   00 00   00  00   00 00   15 00   16  00   00 00   17 00   12 00   13 180   21  00   14  00   04 00   02 00
18 00   01 00   00 00   00 00   00  00   00 00   15 00   16  00   01 00   17 00   12 00   12  00   12  00   18  00   00 00   00 00
16 00   07 -90  10 -90  07 00   00  00   00 00   25 00   23  00   03 00   25 00   26 00   27  00   12  00   16  00   00 00   00 00
16 00   07 180  08 00   10 00   00  00   00 00   17 00   16  00   00 00   14 180  22 00   13  00   12  00   16  00   03 00   00 00
13 180  14 00   11 00   10 00   14 -90   21 00   13 90   13 180   21 00   14 00   02 00   15  00   12  00   18  00   01 00   00 00